---------------
===============
=*************=
=*=***=*=*****=
=*=====*=====*=
=*************=
=*=*=*=*===*=*=
=*=*=*=*=***=*=
=*=*===-=*=*=*=
=*******=*=***=
=*=*=*=*=*=*=*=
=*=*=*=*===*=*=
=*=***=*****=*=
=*===*=*=====*=
=*************=
===============



